NO textures/EG3.xpm
SO textures/EG4.xpm
WE textures/EG2.xpm
EA textures/EG1.xpm

 F  0, 178, 128
C 135,206,235

               111
               101
              11011
             1100011
            110000011          
           11000011111        
          11000000000111   
         1100000001000011   
        110000N000100000111
       110000000001100000011
      111000000000000000000111
    1110000000000000000000000111
   110000000011110000000010000111
  11000000000000000000000100000111
 11000000000000000000000000000000111
111111111111111111111111111111111111
