NO textures/EG1.xpm
SO textures/EG2.xpm
WE textures/EG3.xpm
EA textures/EG4.xpm

F  246, 215, 176
C 135,206,235

               111
               101
              11011
             1100011
             1000001
            110000011   
            100000001          
           110000011111   
          11000000000011   
          10000000000001   
         1100000001000011   
        110000W000100000111
       110000000001100000011
      111000000000000000000111
    1110000000000000000000000111
   110000000011110000000010000111
  11000000000000000000000100000111
 11000000000000000000000000000000111 
111111111111111111111111111111111111
