WE textures/EG3.xpm

NO		 textures/EG1.xpm



SO textures/EG2.xpm
EA textures/EG4.xpm

F  218, 177, 130
C 135,206,235

               111
               101
              11011
             1100011
             1000001
            110000011   
            100000001          
           110111111111   
          11000000000011   
          10000000000001   
         1100000001000011   
        11100E0000100000111
       110100000001100000011
      111010000000100000000111
    1110000000000010000000000111
   110000000111111100000010000011
  11000000000000000000000100000011
 1100000000000000000000000000000011 
111111111111111111111111111111111111