NO ./path_to_the_north_texture
SO ./path_to_the_south_texture


WE ./path_to_the_west_texture
EA ./path_to_the_east_texture

EA ./path_new_east
F 220,100,0

C 225,30,0


11111111111
10001100001
11000001111
10000001
10010001
10000001
11111111
