NO textures/greystone.xpm
SO textures/mossy.xpm
WE textures/bluestone.xpm
EA textures/purplestone.xpm

 F 70,80,20
C 135,206,235


1111111           1111111
1001011111        1001011111
10000000011111    110000011
1100000000N1011   111111111
11000000000000111
 10000000000001
 100000001000011
 100000001000001
 100000001001111
 100000000001
 100000000011
 10000111111
 100001
 10000111111
 1000000001
 1000000011
 111111111