NO ./path_to_the_north_texture
SO ./path_to_the_south_texture
WE ./path_to_the_west_texture
EA ./path_to_the_east_texture
F 220,10n0,0
C 225,30,0

111111
10T111
101001
110001
111111
